1,N,1,2
1,N,1,5
1,S,1,3
1,S,1,4
2,S,1,3
2,S,1,4

6,F,1,3
6,F,1,4

10,F,1,2
10,F,1,5
11,N,1,1
11,N,1,3
11,N,1,4
11,N,1,6

18,F,1,1
18,F,1,3
18,F,1,5

22,F,1,2
22,F,1,4
22,F,1,6

28,H,1,2
28,H,1,5

32,H,1,2
32,H,1,3
32,H,1,4
32,H,1,5

40,S,1,2
40,S,1,5
41,H,1,2
41,H,1,5
41,S,1,1
41,S,1,3
41,S,1,4
41,S,1,6

48,H,1,1
48,H,1,3
49,F,1,2
50,H,1,4
50,H,1,6
51,F,1,5

60,H,1,2
60,H,1,5
61,F,1,2
61,F,1,5
61,H,1,1
61,H,1,3
61,H,1,4
61,H,1,6
64,F,1,1
64,F,1,2
66,F,1,5
66,F,1,6